************
************
************
****  ******
****     ***
**** *I  ***
****O**C****
***      ***
*** * R  ***
***    *****
************
************