************
************
************
*****   ****
*** C * ****
*** *  I ***
***    * ***
**** *   ***
****R  *****
************
************
************