*****  *****
*****R     *
****   **  *
 II* * ** **
     C  *C**
*  * *    **
****   **C**
*********  *
****I      *
************
************
************